SAW ISTANBUL       TURKEY
AYT ANTALYA	   TURKEY
BRU BRUSSELS	   BELGIUM
DUB DUBLIN	   IRELAND
CDG PARIS	   FRANCE
BER BERLIN	   GERMANY	
BCN BARCELONA	   SPAIN
CIA ROME	   ITALY
VCE VENICE	   ITALY
IEV KIEV	   UKRAINE
ATH ATHENS	   GREECE
TLV TEL-AVIV	   ISRAEL
TUN TUNIS          TUNISIA
EWR NEW-YORK       USA	
SFO SAN-FRANSISCO  USA
MEX MEXICO-CITY	   MEXIC
BSB BRASILIA	   BRAZIL
CPH COPENHAGEN     DENMARK
HEL HELSINKI       FINLAND
ARM STOCKHOLM      SWEDEN
OSL OSLO 	   NORWAY
LCY LONDON-CITY    UK
LPL LIVERPOOL 	   UK
AMS AMSTERDAM 	   HOLLAND